 S                       
 #                       
 l  c##l##l#### #        
 #  #        t  #t##c    
 #  #        #  #   #    
 c##c        #  #   #    
             c##c   l    
       #l#          #    
  ###               #    
   t            ####c    
   #    c##c     t       
        #  #     #       
#       #  #     #       
l   c##t#  c##l##c       
#   #   #                
    *                    
    F                    